+------------------------------+----------+----------+---------+----------+
|                              |     Min. |     Max. |    Mean |     Std. |
+==============================+==========+==========+=========+==========+
| Distance to Closest Obstacle | 1.03883  |  8.79124 | 2.34817 | 0.893579 |
+------------------------------+----------+----------+---------+----------+
| Average Visibility           | 2.78167  | 13.23    | 5.86666 | 2.03303  |
+------------------------------+----------+----------+---------+----------+
| Dispersion                   | 0        |  7.03226 | 4.30978 | 0.889167 |
+------------------------------+----------+----------+---------+----------+
| Characteristic Dimension     | 0.557138 | 18.1191  | 4.02105 | 2.67897  |
+------------------------------+----------+----------+---------+----------+
| Tortuosity                   | 1        |  1.98715 | 1.20502 | 0.145374 |
+------------------------------+----------+----------+---------+----------+